50
50
11111111111111111111111111111111111111111111111111
1100g001100k00100000000000000000000100s001100o0011
11003001100300100110011111001111100100300110030011
11112111111211100110011111001100100111211111121111
11110111111011100110011000001111100111011111101111
11110111111011100110011000001111100111011111101111
14010111111011100110011111001100000111011111101041
10020000000000000110011111001100000000000000002001
11111110011001100000000000000000000110011001111111
10030020000001111111111100111111111110000002003001
10000010000001111111111100111111111110000001000001
11111110000000011111111100111111111000000001111111
10000000000000000000000030000000000000000000000001
10000000000000000001111111111110000000000000000001
10000000000000000000011111111000000000000000000001
10000000000000000000000111100000000000000000000001
10000000000000000000000011000000000000000000000001
10000000000000000000000000000000000000000000000001
10000000000000000000000000000000000000000000000001
10000000000000000000000000000000000000000000000001
10000000000000000000000000000000000000000000000001
10000000000000000000000000000000000000000000000001
10000000000000000000000000000000000000000000000001
10000000000000000000000000000000000000000000000001
10000000000000000000000000000000000000000000000001
1a00a00a00a00a00a00a00a00a00a00a00a00a00a00a00a001
10000000000000000000000000000000000000000000000001
10000000000000000000000000000000000000000000000001
10000000000000000000000000000000000000000000000001
10000000000000000000000000000000000000000000000001
10000000000000000000000000000000000000000000000001
10000000000000000000000000000000000000000000000001
10000000000000000000000000000000000000000000000001
10000000000000000000000000000000000000000000000001
10000000000000000000000000000000000000000000000001
10000000000000000000000000000000000000000000000001
10000000000000000000000000000000000000000000000001
10000000000000000000000000000000000000000000000001
10000000000000000000000000000000000000000000000001
10000000000000000000000000000000000000000000000001
10000000000000000000000000000000000000000000000001
10000000000000000000000000000000000000000000000001
10000000000000000000000000000000000000000000000001
10000000000000000000000000000000000000000000000001
10000000000000000000000000000000000000000000000001
10000000000000000000000000000000000000000000000001
10000000000000000000000000000000000000000000000001
10000000000000000000000000000000000000000000000001
10000000000000000000000000000000000000000000000001
11111111111111111111111111111111111111111111111111