20
20
11111111111111111111
10000001000000001111
10111031000000001c11
10111111111110000001
1011111111c110000001
10011001100012100001
10011001100013100001
10011000000011100001
10000000000000000001
10000011100000000001
1210000d100000000001
13111111100000000001
11111111100000000001
10000000000011100001
1000000000001c100001
10101010100010100001
1e1i1m1q100000000001
11111111100000000001
14200000000000000001
11111111111111111111

