50
34
11111111111111111111111111111111111111111111111111
1e010000000000000000000000000000000000000000000001
100300111101111011110011011101100111101111011110i1
11112110000000000000000000000000000000000000001111
10000000000000000000000000000000000000000000000011
11111000000000000000300000000000000000000000000001
1000200000000000000000000000000000a000000000000001
11111000000000000000000000000000000000000000000001
10000000000000000000000000000000000000000000000001
10000000000000000000000000000000000000000000000001
100000000000a0000000000000000000000000000000000001
10000000000000000111110000000000000000000000000001
10000000000000000000000000000000000000000000000001
10000000000000000000000000000000000000000000000001
10000000000000000031000000000000000000000000000001
10000000011211000000000000000000000000000000000001
100000000000000000000000d0000000000000000000000001
10000000000000000000000000000000000000000000000001
10000000000000000000002000000000000000000000000011
10000000000000000000000000000000000000000000000001
10000000000000000000000000000000000000000003000001
10000000000000000000000000000000000000000000000001
10000000000000000000000000000000000000000000000001
10000000000000000000000000000000000000000000000001
100000000000c000000000000000000000b000000000000001
10000000000000000000000000000000000000000000000001
10000000000000000000000000000000000000000000001111
10000001010000000000000000000000000000000000002001
10000000011111000000000000000000000000000000001111
10000001000000000000000000000000000000000000000001
1111100101111100000000000a000000000000a00000011111
10003111210000000000000300000000000000000011100001
1m0000000100000000000000000000000000000000000000q1
11111111111111111111111111111111111111111111111111