50
34
11111111111111111111111111111111111111111111111111
1g010000000000000000000000000000000000000000000001
100000111101111011110011011101100111101111011110e1
11111110000000000000000000000000000000000000001111
10000000000000000000000000000000000000000000000011
10000000000000000000000000000000000000000000000001
1000000000000000000000000000000000a000000000000001
10000000000000000000000000000000000000000000000001
10000000000000000000000000000000000000000000000001
10000000000000000000000000000000000000000000000001
100000000000a0000000000000000000000000000000000001
10000000000000000111110000000000000000000000000001
10000000000000000000000000000000000000000000000001
10000000000000000000000000000000000000000000000001
10000000000000000000000000000000000000000000000001
10000000011111000000000000000000000000000000000001
100000000000000000000000d0000000000000000000000001
10000000000000000000000000000000000000000000000001
10000000000000000000000000000000000000000000000011
10000000000000000000000000000000000000000000000001
10000000000000000000000000000000000000000000000001
10000000000000000000000000000000000000000000000001
10000000000000000000000000000000000000000000000001
10000000000000000000000000000000000000000000000001
100000000000c000000000000000000000b000000000000001
10000000000000000000000000000000000000000000000001
10000000000000000000000000000000000000000000000001
10000000000000000000000000000000000000000000000001
10000000000000000000000000000000000000000000000001
10000000000000000000000000000000000000000000000001
1000000000000000000000000a000000000000a00000000001
10000000000000000000000000000000000000000000000001
10000000000000000000000000000000000000000000000001
11111111111111111111111111111111111111111111111111